w w w w w w w w w w w w w w w w w w w w
w . . . . c . . c . . . . . . . . . . w
w . w w . w w w . . . . . . . w . w . w
w . w w . w w w . . . . . . w w . w . w
w c w . . w w w c . . . . w . . . w . w
w . w c w w w w . . . . . . . w . w . w
w c w . w w w . . . . w . w . . . w . w
w . . . w w w . w . . w . w w w . . . w
w w c . . . . c w . . w . . . . . . w w
. . . w w . . . . . . w . . . w . . . . 
w w . . w . . . . . . w . . w w . . w w 
w . . . . . w w . w w w . . . . . . . w 
w . w . . . . . . . . w . . . w w w . w 
w . w . w w w w w . . w . . . w . . . w 
w . w . . . w w w . . w . . . w . w . w
w . w w w . w w w . . . . . . . . . . w
w . . . w . . . . . . . . . w w . . . w
w . w . w w . . w w w w w . . w w w . w
w . . . . . . . . . . . . . . . . . . w
w w w w w w w w w w w w w w w w w w w w
